174 63
TTTTTTTTTTTTTTTTTTTTTTTTTTTTTTTTTTTTTTTTTTTTTTTTTTTTTTTTTTTTTTTTTTTTTTTTTTTTTTTTTTTTTTTTTTTTTTTTTTTTTTTTTTTTTTTTTTTTTTTTTTTTTTTTTTTTTTTTTTTTTTTTTTTTTTTTTTTTTTTTTTTTTTTTTTTTT
T                                                                                                                                                                           T
T                                                                                                                                                                           T
T                                                                                                                                                                           T
T                                                                                                                                                                           T
T                                                                                                                                                                           T
T                                                                                                                                                                           T
T                                                                                                                                                                           T
T                                                                                                                                                                           T
T                                                                                                                                                                           T
T                                                                                                                                                                           T
T                                                                                                                                                                           T
T                                                                                                                                                                           T
T                                                                                                                                                                           T
T                                                                                                                                                                           T
T                                                                                                                                                                           T
T                                                                                                                                                                           T
T                                                                                                                                                                           T
T                                                                                                                                                                           T
T                                                                                                                                                                           T
T                                                                                                                                                                           T
T                                                                                                                                                                           T
T                                                                                                                                                                           T
T                                                                                                                                                                           T
T                                                                                                                                                                           T
T                                                                                                                                                                           T
T                                                                                                                                                                           T
T                                                                                                                                                                           T
T                                                                                                                                                                           T
T                                                                                                                                                                           T
T                                                                                                                                                                           T
T                                                                                                                                                                           T
T                                                                                                                                                                           T
T                                                                                                                                                                           T
T                                                                                                                                                                           T
T                                                                                                                                                                           T
T                                                                                                                                                                           T
T                                                                                                                                                                           T
T                                                                                                                                                                           T
T                                                                                                                                                                           T
T                                                                                                                              @$                                           T
T                                                                                                                              @$@$                                         T
T                                                                                                                             @@$@$@$                                       T
T                                                                                                                            2$$@$@$@$                                      T
T                                                                                                                          @$@$@$$@$$@$                                     T
T                                                                                                                           @$$$$$@$24                                      T
T                                                                                                                        @$$$$$$$$@$@$@$                                    T
T                                                                                                                     @$@$$$$$$$$$$$$$@$$$                                  T
T                                                                                                                      @$$$$$$$$$$$$@$@$@$@                                 T
T                                                                                                                    $@$@$@$$$$$$$$$$@$@$@$$                                T
T                                                                                                                      @$@$@$$@@$@$@$@$$$$$$$                               T
T                                                                                                                    @$@$$$@$@$$$@$@$@$@$@$                                 T
T                                                                                                                       @$@$$$$$$$$@$@$@$@$                                 T
T                                                                                                                  @$@$@$$$$@$@$@$@$@$@$@$@$@$@$                            T
T                                                                                                                      @$@$@$@$$$$$$$$$$@$@$                                T
T                                                                                                                $@$$@$@@@@$$@$$$@$@$$$@$@$$@$$                             T
T                                                                                                                            ||||||                                         T
T                                                                                                                            |/ \||                                         T
T                                                                                                                            |   ||                                         T
T                                                                                                                            |\_/||                                         T
T                                                                                                                            ||||||                                         T
T                                                                                                                            ||||||                                         T
TTTTTTTTTTTTTTTTTTTTTTTTTTTTTTTTTTTTTTTTTTTTTTTTTTTTTTTTTTTTTTTTTTTTTTTTTTTTTTTTTTTTTTTTTTTTTTTTTTTTTTTTTTTTTTTTTTTTTTTTTTTTTTTTTTTTTTTTTTTTTTTTTTTTTTTTTTTTTTTTTTTTTTTTTTTTT
